15 20
__##################
_###################
_###################
_######^^###########
_######^^^^^########
_#######^^^^^#######
_#######^^^^^^######
_########^^^^^######
_#########^^^^^#####
_##########^^^^#####
_############^######
__##################
___#################
______##############
__________##########
